x---------------------------------------
x---------------------------------------
x---------------------------------------
x--------------------------------------x
x--------------------------------------x
x------------------------xxxxx---------x
x--------------------------------------x
x----------------------------------xxxxx
xxxxxxxxxxxx---------------------------x
x---------------------xxxxxxx----------x
x--------------------------------------x
x-------------xxx----------------------x
x--------------------------------------x
x-----xxxxx--------------------xxx-----x
x------------------------------x----xxxx
x------------------------------x--------
x------------------------------x-------x
xxxxxxxxxxxxxxxxxxxxxxxxxxxxxxxxxxxxxxxx